10
0040000401
0040000400
0000000000
4400000000
0000000000
0000004444
0000000000
0000040000
3000040002